+++++++++++++++++++++++++++
+.........................+
+.++++++++++.++.+++++++++.+
+.++++++++++.++.+++++++++.+
+F.....++....++...++...F..+
+++.++.++.+++++++.++.++.+++
+++.++.++.+++++++.++.++.+++
+...++...............++...+
+.++++.+++++.++.++++.++++.+
+.++++.+++++.++.++++.++++.+
+............++...........+
++++++.++.+++++++.++.++++++
++++++.++.+++++++.++.++++++
++++++.++.........++.++++++
++++++.++.+++++++.++.++++++
++++++.++.+..C..+.++.++++++
..........+.....+..........
++++++.++.+.....+.++.++++++
++++++.++.+++..++.++.++++++
++++++.++.........++.++++++
++++++.+++++.++.++++.++++++
++++++.+++++.++.++++.++++++
+......++....++...++..F...+
+.++++.++.+++++++.++.++++.+
+.++++.++.+++++++.++.++++.+
+.........F...............+
+.++++.+++++.++.++++.++++.+
+.++++.+++++.++.++++.++++.+
+.++++.+++++.++.++++.++++.+
+...F........++...........+
+++++++++++++++++++++++++++
