+.++++++++
+.........
+.+++++++.
+.+++++++.
+F.....++.
+++.++.++.
+++.++.++.
+...++....
+.++++C++.
+......++.
